XXXXXXXXXXXXXXX
X             X
X XXXXXXXXXXX X
X XS        X X
E XXXXXXXXX X X
X XXXXXXXXX   X
XXXXXXXXXXXXXXX
